Hodnocené části:
 1) Automatické testy a manuální hodnocení implementace:
      zahrnuje automatické testy včetně testů registrovaných rozšíření
               hodnocení implementace předepsané metody syntaktické analýzy,
               dodržení varianty zadání v implementaci (symtable.c),
               přehlednost a kvalita kódu.
    Následuje orientační ceník za nejčastější chyby a prohřešky včetně několika zkratek, které se mohou vyskytovat v komentářích hodnocení implementace:
      NOHEAD = chybí záhlaví ve zdroj. souborech: -0,50 b
      NOAUTHORS = chybí jména autorů v záhlaví: -0,20 b
      PMGP = nadměrné množství globálních proměnných: -0,20 b (tolerována globální proměnná pro chybu, tabulku symbolů a seznam instrukcí)
      HEADCODE = kód v hlavičkových souborech místo v .c souborech: -0,15 b
      LCOM++ = téměř žádné komentáře: -0,30 b
      LCOM = málo komentářů: -0,10 b
      GCOM = příliš mnoho komentářů: -0,10 b
      NOCOMH = chybí komentáře u deklarací důležitých funkcí v .h: -0,10 b
      FUNCDECLH = chybí deklarace funkcí v .h: -0,10 b
      MIXENCZ = kombinování anglického a českého jazyka v komentářích: -0,10 b
      INDENTATION = špatné/nevhodné odsazení bloků: bez postihu
      TOOLONGFUNCS = příliš dlouhé funkce (lépe provést dekompozici): bez postihu
      CLEAN = celková úprava kódu (více prohřešků): -0,50 b (odsazení, zakomentované zbytky kódu, ...)
      COPYPASTE = kopírování kódu místo vytvoření vhodné funkce: -0,10 b
      VUL = vulgarismy: -0,30 b
      NORS/PA = SA analýza chybí: -0,60 b
      NOPSA = SA analýza výrazů chybí: -0,60 b
      IAL+ = TS v jiném souboru než symtable.(c|h): -0,10 b
      NOTS/IAL++ = chybí TS dle zadání: -0,60 b
 2) Prémiové body, korekce, malus: aktivita na fóru, rychlostní soutěž,
                                   pozdní odevzdání, formální nedostatky.
 3) Dokumentace (viz zadání a seznam zkratek níže).
    Následuje seznam zkratek, které se mohou vyskytnout v komentářích k hodnocení dokumentace:
      KA = chyby v KA, především větší míra nedeterminismu, chybějící důležité lexémy (např. ošetření komentářů atp.)
      strukt. = nedostatky ve struktuře dokumentu (nejčastěji chybějící závěr)
      PSA = chybějící nebo nedostatečný popis precedenční syntaktické analýzy
      RP = chybějící popis rozdělení práce
      GK = chybějící/nedostatečný popis generování kódu
      1. strana = chybějící informace na 1. straně dokumentace
      LL = chyby a nedostatky v LL tabulce
      LLT = chybějící nebo chybná LL tabulka
      typ. = typografické nedostatky (nejčastěji text nebyl zarovnán do bloku)
      term. = nepřesná terminologie
      SA = nedostatečný/chybějící popis syntaktické analýzy
      SAV = nedostatečný popis syntaktické analýzy výrazů
      SéA = chybějící/nedostatečný popis sémantické analýzy (typicky není dobře popsáno, co všechno se kontroluje)
      PT = chybějící, chybná nebo nečitelná precedenční tabulka
      TS = chybějící/nedostatečný popis tabulky symbolů či její implementace
      SHORT = nedostatečný, nekonkrétní popis řešení
      gram. = gramatické chyby
      LANG = míchání jazyků v rámci dokumentace (nejčastěji češtiny a slovenštiny)
      HOV = použití hovorových výrazů
      BLOK = text není zarovnán do bloku
      KAPTXT = dokumentace obsahuje více nadpisů hned za sebou
    Za většinu prohřešků bylo podle závažnosti strhnuto 0,1 až 0,7 bodu.
    Poznámky k hodnocení dokumentací jsou vesměs řazeny dle klesající závažnosti.
